%%%%%%%
%.%P% %
% % % %
%     %
% %%% %
%  .  %
%%%%%%%