%%%%%%%
%.%P% %
% % % %
%     %
% %%% %
%     %
%%%%%%%